12 23 23 23 23 23 23 23 23 23 23 23 23 23 23 13
20 11 11 11 11 11 11 11 11 11 11 11 11 11 11 21
20 11 11 11 11 11 11 11 11 11 11 11 11 11 11 21
20 11 11 11 11 11 11 11 11 11 11 11 11 11 11 21
20 11 11 11 11 11 11 11 11 11 11 11 11 11 11 8
20 11 11 11 11 11 11 11 11 11 11 11 11 11 11 8
20 11 11 11 11 11 11 11 11 11 11 11 11 11 11 21
20 11 11 11 11 11 11 11 11 11 11 11 11 11 11 21
20 11 11 11 11 11 11 11 11 11 11 11 11 11 11 21
14 22 22 22 22 22 22 22 22 22 22 22 22 22 22 15